11111111111111
1C000F000000C1
11100110C10101
100F111111C101
1P0011E0000001
11111111111111