1111111111111111111
1CCCCF000000C0100C1
11100110C1010010011
11100110C10100101C1
11100110C1010010001
1000111111C1000C111
1P0011E0000F0011101
1111111111111111111