11111111111111
1C0100000000C1
10000111110001
11100110C10101
1C0000000100C1
1000111111C101
1P0011E0000001
11111111111111